10 10 1.5 1.5 0
##########
#____#___#
#######_##
#______#_#
#_#_#_##_#
#####____#
#__#__##_#
#__#___#_#
#____#_#_#
##########
